./3D/extension.json:	"manifest_version": 2,
./AbsenteeLandlord/extension.json:	"manifest_version": 1
./AbuseFilterBypass/extension.json:	"manifest_version": 2
./AbuseFilter/extension.json:	"manifest_version": 2
./AccessControl/extension.json:	"manifest_version": 2
./AccountInfo/extension.json:	"manifest_version": 2
./AControlImageLink/extension.json:	"manifest_version": 2
./Acrolinx/extension.json:	"manifest_version": 1
./ActiveAbstract/extension.json:	"manifest_version": 2
./AddHTMLMetaAndTitle/extension.json:	"manifest_version": 2
./AddMessages/extension.json:	"manifest_version": 2
./AddPersonalUrls/extension.json:	"manifest_version": 2
./AddThis/extension.json:	"manifest_version": 2
./AdManager/extension.json:	"manifest_version": 2
./AdminLinks/extension.json:	"manifest_version": 1
./AdvancedMeta/extension.json:	"manifest_version": 2
./AdvancedSearch/extension.json:	"manifest_version": 2
./AJAXPoll/extension.json:	"manifest_version": 2
./AjaxShowEditors/extension.json:	"manifest_version": 2
./AkismetKlik/extension.json:	"manifest_version": 2
./AllTimeZones/extension.json:	"manifest_version": 1
./AnchorHandler/extension.json:	"manifest_version": 2
./AnonPrivacy/extension.json:	"manifest_version": 2
./AntiSpoof/extension.json:	"manifest_version": 2
./ApiFeatureUsage/extension.json:	"manifest_version": 2
./ApprovedRevs/extension.json:	"manifest_version": 1
./Arrays/extension.json:	"manifest_version": 2
./ArticleCreationWorkflow/extension.json:	"manifest_version": 2,
./ArticleFeedbackv5/extension.json:	"manifest_version": 2
./ArticleIndex/extension.json:	"manifest_version": 2
./ArticleMetaDescription/extension.json:	"manifest_version": 1
./ArticlePlaceholder/extension.json:	"manifest_version": 2
./ArticleRatings/extension.json:	"manifest_version": 2
./ArticleToCategory2/extension.json:	"manifest_version": 2
./Athena/extension.json:	"manifest_version": 1,
./AuthorProtect/extension.json:	"manifest_version": 2
./Auth_remoteuser/extension.json:	"manifest_version": 2
./AutoCategoriseUploads/extension.json:	"manifest_version": 2
./AutoCreateCategoryPages/extension.json:	"manifest_version": 1
./AutoGallery/extension.json:	"manifest_version": 2
./Babel/extension.json:	"manifest_version": 2
./BaseHooks/extension.json:	"manifest_version": 2
./BatchUserRights/extension.json:	"manifest_version": 2
./BetaFeatures/extension.json:	"manifest_version": 2
./BiblioPlus/extension.json:	"manifest_version": 2
./BibManager/extension.json:	"manifest_version": 2
./Blackout/extension.json:	"manifest_version": 2
./BlockAndNuke/extension.json:	"manifest_version": 2
./BlockInactive/extension.json:	"manifest_version": 2
./BlogPage/extension.json:	"manifest_version": 1
./BlueSpiceAbout/extension.json:	"manifest_version": 2
./BlueSpiceArticleInfo/extension.json:	"manifest_version": 2
./BlueSpiceArticlePreviewCapture/extension.json:	"manifest_version": 2
./BlueSpiceAuthors/extension.json:	"manifest_version": 2
./BlueSpiceAvatars/extension.json:	"manifest_version": 2
./BlueSpiceBookshelf/extension.json:	"manifest_version": 2
./BlueSpiceCategoryCheck/extension.json:	"manifest_version": 2
./BlueSpiceCategoryManager/extension.json:	"manifest_version": 2
./BlueSpiceChecklist/extension.json:	"manifest_version": 2
./BlueSpiceConfigManager/extension.json:	"manifest_version": 2,
./BlueSpiceContextMenu/extension.json:	"manifest_version": 2
./BlueSpiceCountThings/extension.json:	"manifest_version": 2
./BlueSpiceCustomMenu/extension.json:	"manifest_version": 2
./BlueSpiceDashboards/extension.json:	"manifest_version": 2
./BlueSpiceDistributionConnector/extension.json:	"manifest_version": 2
./BlueSpiceEchoConnector/extension.json:	"manifest_version": 2
./BlueSpiceEmoticons/extension.json:	"manifest_version": 2
./BlueSpiceExpiry/extension.json:	"manifest_version": 2
./BlueSpiceExportTables/extension.json:	"manifest_version": 2
./BlueSpiceExtendedFilelist/extension.json:	"manifest_version": 2
./BlueSpiceExtendedSearch/extension.json:	"manifest_version": 2
./BlueSpiceExtendedStatistics/extension.json:	"manifest_version": 2
./BlueSpiceFilterableTables/extension.json:	"manifest_version": 2
./BlueSpiceFlaggedRevsConnector/extension.json:	"manifest_version": 2
./BlueSpiceFoundation/extension.json:	"manifest_version": 2,
./BlueSpiceGroupManager/extension.json:	"manifest_version": 2
./BlueSpiceHideTitle/extension.json:	"manifest_version": 2
./BlueSpiceInsertCategory/extension.json:	"manifest_version": 2
./BlueSpiceInsertFile/extension.json:	"manifest_version": 2,
./BlueSpiceInsertLink/extension.json:	"manifest_version": 2,
./BlueSpiceInsertMagic/extension.json:	"manifest_version": 2,
./BlueSpiceInsertTemplate/extension.json:	"manifest_version": 2
./BlueSpiceInterWikiLinks/extension.json:	"manifest_version": 2
./BlueSpiceMultiUpload/extension.json:	"manifest_version": 2
./BlueSpiceNamespaceCSS/extension.json:	"manifest_version": 2
./BlueSpiceNamespaceManager/extension.json:	"manifest_version": 2
./BlueSpiceNSFileRepoConnector/extension.json:	"manifest_version": 2
./BlueSpicePageAccess/extension.json:	"manifest_version": 2
./BlueSpicePageAssignments/extension.json:	"manifest_version": 2
./BlueSpicePageFormsConnector/extension.json:	"manifest_version": 2
./BlueSpicePagesVisited/extension.json:	"manifest_version": 2
./BlueSpicePageTemplates/extension.json:	"manifest_version": 2
./BlueSpicePageVersion/extension.json:	"manifest_version": 2
./BlueSpicePermissionManager/extension.json:	"manifest_version": 2
./BlueSpicePlayer/extension.json:	"manifest_version": 2
./BlueSpicePrivacy/extension.json:	"manifest_version": 2
./BlueSpiceProDistributionConnector/extension.json:	"manifest_version": 2
./BlueSpiceQrCode/extension.json:	"manifest_version": 2
./BlueSpiceRating/extension.json:	"manifest_version": 2
./BlueSpiceReadConfirmation/extension.json:	"manifest_version": 2
./BlueSpiceReaders/extension.json:	"manifest_version": 2
./BlueSpiceReminder/extension.json:	"manifest_version": 2
./BlueSpiceRSSFeeder/extension.json:	"manifest_version": 2
./BlueSpiceSaferEdit/extension.json:	"manifest_version": 2
./BlueSpiceSignHere/extension.json:	"manifest_version": 2
./BlueSpiceSmartList/extension.json:	"manifest_version": 2
./BlueSpiceSMWConnector/extension.json:	"manifest_version": 2
./BlueSpiceSocialArticleActions/extension.json:	"manifest_version": 2
./BlueSpiceSocialBlog/extension.json:	"manifest_version": 2
./BlueSpiceSocialComments/extension.json:	"manifest_version": 2
./BlueSpiceSocial/extension.json:	"manifest_version": 2
./BlueSpiceSocialMicroBlog/extension.json:	"manifest_version": 2
./BlueSpiceSocialProfile/extension.json:	"manifest_version": 2
./BlueSpiceSocialRating/extension.json:	"manifest_version": 2
./BlueSpiceSocialResolve/extension.json:	"manifest_version": 2
./BlueSpiceSocialTags/extension.json:	"manifest_version": 2
./BlueSpiceSocialTimelineUpdate/extension.json:	"manifest_version": 2
./BlueSpiceSocialTopics/extension.json:	"manifest_version": 2
./BlueSpiceSocialWatch/extension.json:	"manifest_version": 2
./BlueSpiceSocialWikiPage/extension.json:	"manifest_version": 2
./BlueSpiceSubPageTree/extension.json:	"manifest_version": 2
./BlueSpiceTagCloud/extension.json:	"manifest_version": 2
./BlueSpiceUEModuleBookPDF/extension.json:	"manifest_version": 2
./BlueSpiceUEModuleDOCX/extension.json:	"manifest_version": 2
./BlueSpiceUEModuleHTML/extension.json:	"manifest_version": 2
./BlueSpiceUEModulePDF/extension.json:	"manifest_version": 2,
./BlueSpiceUEModulePDFRecursive/extension.json:	"manifest_version": 2
./BlueSpiceUEModulePDFSubpages/extension.json:	"manifest_version": 2
./BlueSpiceUEModuleTable2Excel/extension.json:	"manifest_version": 2
./BlueSpiceUniversalExport/extension.json:	"manifest_version": 2,
./BlueSpiceUsageTracker/extension.json:	"manifest_version": 2
./BlueSpiceUserInfo/extension.json:	"manifest_version": 2
./BlueSpiceUserManager/extension.json:	"manifest_version": 2
./BlueSpiceUserSidebar/extension.json:	"manifest_version": 2
./BlueSpiceVisualDiff/extension.json:	"manifest_version": 2
./BlueSpiceVisualEditorConnector/extension.json:	"manifest_version": 2
./BlueSpiceWatchList/extension.json:	"manifest_version": 2
./BlueSpiceWhoIsOnline/extension.json:	"manifest_version": 2
./BlueSpiceWikiExplorer/extension.json:	"manifest_version": 2
./BoilerPlate/extension.json:	"manifest_version": 2
./BounceHandler/extension.json:	"manifest_version": 2
./BreadCrumbs2/extension.json:	"manifest_version": 2
./BreadCrumbs/extension.json:	"manifest_version": 2
./BrickipediaExtra/extension.json:	"manifest_version": 1
./Buggy/extension.json:	"manifest_version": 1
./Calendar/extension.json:	"manifest_version": 2
./CampaignEvents/extension.json:	"manifest_version": 2
./Campaigns/extension.json:	"manifest_version": 2
./Capiunto/extension.json:	"manifest_version": 2
./Cargo/extension.json:	"manifest_version": 1
./Carp/extension.json:	"manifest_version": 2
./CategoryExplorer/extension.json:  "manifest_version": 2
./CategoryLockdown/extension.json:	"manifest_version": 2,
./CategorySortHeaders/extension.json:	"manifest_version": 2
./CategoryTagSorter/extension.json:	"manifest_version": 2
./CategoryTests/extension.json:	"manifest_version": 1
./CategoryTree/extension.json:	"manifest_version": 2
./CategoryWatch/extension.json:	"manifest_version": 1
./CentralAuth/extension.json:	"manifest_version": 2
./CentralLogging/extension.json:	"manifest_version": 2
./CentralNotice/extension.json:	"manifest_version": 2
./Challenge/extension.json:	"manifest_version": 1
./ChangeAuthor/extension.json:	"manifest_version": 1
./ChangeUserPasswords/extension.json:	"manifest_version": 1
./CharInsert/extension.json:	"manifest_version": 2
./CharRangeSpan/extension.json:	"manifest_version": 2
./Checkpoint/extension.json:	"manifest_version": 1
./CheckUser/extension.json:	"manifest_version": 2
./ChessBrowser/extension.json:	"manifest_version": 2
./CIForms/extension.json:	"manifest_version": 2
./CirrusSearch/extension.json:	"manifest_version": 2
./CiteDrawer/extension.json:	"manifest_version": 2
./Cite/extension.json:	"manifest_version": 2
./CiteThisPage/extension.json:	"manifest_version": 2
./Citoid/extension.json:	"manifest_version": 2
./cldr/extension.json:	"manifest_version": 2
./CleanChanges/extension.json:	"manifest_version": 1
./CloneDiff/extension.json:	"manifest_version": 1
./CloseWikis/extension.json:	"manifest_version": 2
./CodeEditor/extension.json:	"manifest_version": 2
./CodeMirror/extension.json:	"manifest_version": 2
./CodeReview/extension.json:	"manifest_version": 2
./Cognate/extension.json:	"manifest_version": 2
./CognitiveProcessDesigner/extension.json:	"manifest_version": 2
./CollaborationKit/extension.json:	"manifest_version": 2
./CollapsibleSections/extension.json:	"manifest_version": 2
./CollapsibleVector/extension.json:	"manifest_version": 1
./Collection/extension.json:	"manifest_version": 2
./Commentbox/extension.json:	"manifest_version": 2
./Comments/extension.json:	"manifest_version": 2
./CommentStreams/extension.json:	"manifest_version": 1,
./CommonsMetadata/extension.json:	"manifest_version": 2
./ConfigManager/extension.json:	"manifest_version": 2,
./ConfirmAccount/extension.json:	"manifest_version": 2
./ConfirmEdit/extension.json:	"manifest_version": 2
./CongressLookup/extension.json:	"manifest_version": 2
./ContactPage/extension.json:	"manifest_version": 2
./ContentTransfer/extension.json:	"manifest_version": 2
./ContentTranslation/extension.json:	"manifest_version": 2
./ContributionCredits/extension.json:	"manifest_version": 1
./ContributionScores/extension.json:	"manifest_version": 2
./ContributionsList/extension.json:	"manifest_version": 1
./Contributors/extension.json:	"manifest_version": 1
./CookieWarning/extension.json:	"manifest_version": 1
./CountDownClock/extension.json:	"manifest_version": 2
./CrawlableAllPages/extension.json:	"manifest_version": 2
./CreateAPage/extension.json:	"manifest_version": 2
./CreatedPagesList/extension.json:	"manifest_version": 1
./CreatePage/extension.json:	"manifest_version": 2
./CreatePageUw/extension.json:	"manifest_version": 2
./CreateRedirect/extension.json:	"manifest_version": 2
./CreateUserPage/extension.json:	"manifest_version": 1
./CreditsSource/extension.json:	"manifest_version": 2
./CSS/extension.json:	"manifest_version": 1
./DarkMode/extension.json:	"manifest_version": 2
./Dashiki/extension.json:	"manifest_version": 2
./DataTable2/extension.json:	"manifest_version": 2
./DataTransfer/extension.json:	"manifest_version": 1
./DateDiff/extension.json:	"manifest_version": 2
./DebugTemplates/extension.json:	"manifest_version": 2
./DeleteBatch/extension.json:	"manifest_version": 1
./DeletePagesForGood/extension.json:	"manifest_version": 1
./DeleteUserPages/extension.json:	"manifest_version": 2
./Description2/extension.json:	"manifest_version": 1
./DeviceMapLogCapture/extension.json:	"manifest_version": 1
./Diagnosis/extension.json:	"manifest_version": 2
./DidYouKnow/extension.json:	"manifest_version": 2
./DisableAccount/extension.json:	"manifest_version": 1
./Disambiguator/extension.json:	"manifest_version": 2
./Discourse/extension.json:	"manifest_version": 2
./DiscussionThreading/extension.json:	"manifest_version": 2
./DiscussionTools/extension.json:	"manifest_version": 2,
./DismissableSiteNotice/extension.json:	"manifest_version": 2,
./DisplayTitle/extension.json:	"manifest_version": 2
./DisqusTag/extension.json:	"manifest_version": 1
./DocBookExport/extension.json:	"manifest_version": 1
./DonationInterface/extension.json:	"manifest_version": 2
./DoubleWiki/extension.json:	"manifest_version": 2
./DPLforum/extension.json:	"manifest_version": 1
./Drafts/extension.json:	"manifest_version": 2
./DrawioEditor/extension.json:	"manifest_version": 2
./DumpsOnDemand/extension.json:	"manifest_version": 2,
./Duplicator/extension.json:	"manifest_version": 2
./DynamicPageListEngine/extension.json:	"manifest_version": 2
./DynamicSidebar/extension.json:	"manifest_version": 2
./Echo/extension.json:	"manifest_version": 2,
./EditAccount/extension.json:	"manifest_version": 1
./EditcountAdditions/extension.json:	"manifest_version": 1
./Editcount/extension.json:	"manifest_version": 1
./EditNotify/extension.json:	"manifest_version": 1
./EditSimilar/extension.json:	"manifest_version": 2
./EditSubpages/extension.json:	"manifest_version": 1
./EditUser/extension.json:	"manifest_version": 1
./Elastica/extension.json:	"manifest_version": 2
./ElectronPdfService/extension.json:	"manifest_version": 2,
./EmailAuth/extension.json:	"manifest_version": 2
./EmailAuthorization/extension.json:	"manifest_version": 2
./EmailCapture/extension.json:	"manifest_version": 2
./EmailDiff/extension.json:	"manifest_version": 1,
./EncryptedUploads/extension.json:	"manifest_version": 1
./EnhancedUpload/extension.json:	"manifest_version": 2,
./EntitySchema/extension.json:	"manifest_version": 2
./EtherpadLite/extension.json:	"manifest_version": 2
./EventBus/extension.json:	"manifest_version": 2
./EventLogging/extension.json:	"manifest_version": 2
./EventSimulator/extension.json:	"manifest_version": 2
./EventStreamConfig/extension.json:	"manifest_version": 2
./examples/extension.json:	"manifest_version": 2
./Expressions/extension.json:	"manifest_version": 1,
./ExtensionDistributor/extension.json:	"manifest_version": 2
./ExternalArticles/extension.json:	"manifest_version": 1
./ExternalData/extension.json:	"manifest_version": 2
./ExternalGuidance/extension.json:	"manifest_version": 2
./ExternalLinkConfirm/extension.json:	"manifest_version": 2
./ExtJSBase/extension.json:	"manifest_version": 2
./ExtraLanguageLink/extension.json:	"manifest_version": 2
./FanBoxes/extension.json:	"manifest_version": 1
./Favorites/extension.json:	"manifest_version": 2
./FeaturedFeeds/extension.json:	"manifest_version": 2
./Figures/extension.json:	"manifest_version": 2
./FileAnnotations/extension.json:	"manifest_version": 1
./FileExporter/extension.json:	"manifest_version": 2,
./FileImporter/extension.json:	"manifest_version": 2,
./FilterListUsers/extension.json:	"manifest_version": 1
./FilterSpecialPages/extension.json:	"manifest_version": 2
./FlaggedRevs/extension.json:	"manifest_version": 2
./FlexDiagrams/extension.json:	"manifest_version": 2
./FlexiSkin/extension.json:	"manifest_version": 2,
./FlickrAPI/extension.json:	"manifest_version": 1
./Flow/extension.json:	"manifest_version": 2,
./ForcePreview/extension.json:	"manifest_version": 1
./Form/extension.json:	"manifest_version": 1
./Forms/extension.json:	"manifest_version": 2,
./FormWizard/extension.json:	"manifest_version": 1,
./FundraiserLandingPage/extension.json:	"manifest_version": 2
./FundraisingEmailUnsubscribe/extension.json:	"manifest_version": 1
./FundraisingTranslateWorkflow/extension.json:	"manifest_version": 2
./Gadgets/extension.json:	"manifest_version": 2
./Genealogy/extension.json:	"manifest_version": 1
./GenerateMochaConfig/extension.json:	"manifest_version": 2
./GeoCrumbs/extension.json:	"manifest_version": 2
./GeoData/extension.json:	"manifest_version": 2
./GeoGebra/extension.json:	"manifest_version": 1
./GettingStarted/extension.json:	"manifest_version": 2
./Git2Pages/extension.json:	"manifest_version": 1
./GitGadgets/extension.json:	"manifest_version": 2
./GlobalBlocking/extension.json:	"manifest_version": 2
./GlobalContribs/extension.json:	"manifest_version": 1
./GlobalContributions/extension.json:	"manifest_version": 1
./GlobalCssJs/extension.json:	"manifest_version": 2
./GlobalNotice/extension.json:	"manifest_version": 2
./GlobalPreferences/extension.json:	"manifest_version": 2
./GlobalUsage/extension.json:	"manifest_version": 2
./GlobalUserPage/extension.json:	"manifest_version": 2
./GlobalUserrights/extension.json:	"manifest_version": 1
./GlobalWatchlist/extension.json:	"manifest_version": 2
./GoogleAdSense/extension.json:	"manifest_version": 2
./GoogleAnalyticsMetrics/extension.json:	"manifest_version": 1
./GoogleAnalyticsTopPages/extension.json:	"manifest_version": 1
./GoogleAuthenticator/extension.json:	"manifest_version": 1
./GoogleCustomWikiSearch/extension.json:	"manifest_version": 2
./GoogleDocCreator/extension.json:	"manifest_version": 1
./GoogleDocs4MW/extension.json:	"manifest_version": 2
./GoogleDocTag/extension.json:	"manifest_version": 2
./GoogleGeocode/extension.json:	"manifest_version": 1
./GoogleLogin/extension.json:	"manifest_version": 1
./GoogleNewsSitemap/extension.json:	"manifest_version": 2
./GooglePlaces/extension.json:	"manifest_version": 1
./GoogleSiteSearch/extension.json:	"manifest_version": 1
./GPGMail/extension.json:	"manifest_version": 2
./Graph/extension.json:	"manifest_version": 2
./GraphQL/extension.json:	"manifest_version": 2,
./GraphViz/extension.json:	"manifest_version": 2
./Gravatar/extension.json:	"manifest_version": 2
./GroupsSidebar/extension.json:	"manifest_version": 2
./GroupWhitelist/extension.json:	"manifest_version": 2
./GrowthExperiments/extension.json:	"manifest_version": 2
./GuidedTour/extension.json:	"manifest_version": 2
./GWToolset/extension.json:	"manifest_version": 2
./HAWelcome/extension.json:	"manifest_version": 1
./HeaderTabs/extension.json:	"manifest_version": 1,
./HeadScript/extension.json:	"manifest_version": 2
./HelpPages/extension.json:	"manifest_version": 2
./HidePrefix/extension.json:	"manifest_version": 2
./HierarchyBuilder/extension.json:	"manifest_version": 1
./HitCounters/extension.json:	"manifest_version": 1
./HostStats/extension.json:	"manifest_version": 2
./HoverGallery/extension.json:	"manifest_version": 2
./Hreflang/extension.json:	"manifest_version": 1
./HSTS/extension.json:	"manifest_version": 1
./Html2Wiki/extension.json:	"manifest_version": 1,
./HTMLPurifier/extension.json:	"manifest_version": 2
./HTMLTags/extension.json:	"manifest_version": 2
./I18nTags/extension.json:	"manifest_version": 1
./Ids/extension.json:	"manifest_version": 2
./IframePage/extension.json:	"manifest_version": 2
./ImageCompare/extension.json:	"manifest_version": 2
./ImageMap/extension.json:	"manifest_version": 2
./ImageRating/extension.json:	"manifest_version": 1
./ImageSuggestions/extension.json:	"manifest_version": 2,
./ImageTweaks/extension.json:	"manifest_version": 1
./ImapAuthorization/extension.json:	"manifest_version": 1
./ImportArticles/extension.json:	"manifest_version": 2
./ImportFreeImages/extension.json:	"manifest_version": 2
./ImportOfficeFiles/extension.json:	"manifest_version": 2
./ImportUsers/extension.json:	"manifest_version": 1
./Inbox/extension.json:	"manifest_version": 2
./InlineCategorizer/extension.json:	"manifest_version": 2
./InputBox/extension.json:	"manifest_version": 2
./Insider/extension.json:	"manifest_version": 2
./InteractiveBlockMessage/extension.json:	"manifest_version": 2
./intersection/extension.json:	"manifest_version": 2
./Interwiki/extension.json:	"manifest_version": 2
./InterwikiExtracts/extension.json:	"manifest_version": 2
./InterwikiSorting/extension.json:	"manifest_version": 2
./InviteSignup/extension.json:	"manifest_version": 1
./IPInfo/extension.json:	"manifest_version": 2,
./Josa/extension.json:	"manifest_version": 2
./JSBreadCrumbs/extension.json:	"manifest_version": 2
./JsonConfig/extension.json:	"manifest_version": 2
./JsonData/extension.json:	"manifest_version": 2
./Kartographer/extension.json:	"manifest_version": 2
./LabeledSectionTransclusion/extension.json:	"manifest_version": 2
./LandingCheck/extension.json:	"manifest_version": 2
./LanguageSelector/extension.json:	"manifest_version": 2
./LanguageTag/extension.json:	"manifest_version": 2
./LanguageTool/extension.json:	"manifest_version": 1
./LastModified/extension.json:	"manifest_version": 2
./LastUserLogin/extension.json:	"manifest_version": 2
./LDAPAuthentication2/extension.json:	"manifest_version": 2
./LdapAuthentication/extension.json:	"manifest_version": 2
./LDAPAuthorization/extension.json:	"manifest_version": 2
./LDAPGroups/extension.json:	"manifest_version": 2
./LDAPProvider/extension.json:	"manifest_version": 2
./LDAPSyncAll/extension.json:	"manifest_version": 2,
./LDAPUserInfo/extension.json:	"manifest_version": 2
./LegalLogin/extension.json:	"manifest_version": 2
./Lingo/extension.json:	"manifest_version": 2
./Link_Attributes/extension.json:	"manifest_version": 2
./LinkedWiki/extension.json:	"manifest_version": 2,
./LinkFilter/extension.json:	"manifest_version": 1
./LinkSuggest/extension.json:	"manifest_version": 1
./LinkTarget/extension.json:	"manifest_version": 2
./Linter/extension.json:	"manifest_version": 2
./LiquidThreads/extension.json:	"manifest_version": 2
./Listings/extension.json:	"manifest_version": 2
./LiveChat/extension.json:	"manifest_version": 1
./LocalisationUpdate/extension.json:	"manifest_version": 2
./LockAuthor/extension.json:	"manifest_version": 2
./LockDownEnglishPages/extension.json:	"manifest_version": 1
./Lockdown/extension.json:	"manifest_version": 1
./LogEntry/extension.json:	"manifest_version": 2
./LoginNotify/extension.json:	"manifest_version": 2
./LogoFunctions/extension.json:	"manifest_version": 2
./LookupUser/extension.json:	"manifest_version": 2
./LoopFunctions/extension.json:	"manifest_version": 1
./Loops/extension.json:	"manifest_version": 2
./MachineVision/extension.json:	"manifest_version": 2
./MagicNoCache/extension.json:	"manifest_version": 1
./MagicNumberedHeadings/extension.json:	"manifest_version": 1
./Mailgun/extension.json:	"manifest_version": 1
./Maintenance/extension.json:	"manifest_version": 1
./MaintenanceShell/extension.json:	"manifest_version": 1
./MapSources/extension.json:	"manifest_version": 2
./MarkAsHelpful/extension.json:	"manifest_version": 2
./MassEditRegex/extension.json:	"manifest_version": 2
./MassMessageEmail/extension.json:	"manifest_version": 2
./MassMessage/extension.json:	"manifest_version": 2
./Math/extension.json:	"manifest_version": 2
./MathSearch/extension.json:	"manifest_version": 1
./MediaFunctions/extension.json:	"manifest_version": 2
./MediaModeration/extension.json:	"manifest_version": 2
./MediaSearch/extension.json:	"manifest_version": 2
./MediaUploader/extension.json:	"manifest_version": 2
./MediaWikiChat/extension.json:	"manifest_version": 1
./MediaWikiFarm/extension.json:	"manifest_version": 1
./MenuEditor/extension.json:	"manifest_version": 2
./MergeArticles/extension.json:	"manifest_version": 2
./MessageCommons/extension.json:	"manifest_version": 1
./Metadata/extension.json:	"manifest_version": 2,
./MetaMaster/extension.json:	"manifest_version": 1
./MiniInvite/extension.json:	"manifest_version": 1
./MinimumNameLength/extension.json:	"manifest_version": 1
./MintyDocs/extension.json:	"manifest_version": 1
./MissedPages/extension.json:	"manifest_version": 1
./MixedNamespaceSearchSuggestions/extension.json:	"manifest_version": 2
./MobileApp/extension.json:	"manifest_version": 2
./MobileDetect/extension.json:	"manifest_version": 2
./MobileFrontendContentProvider/extension.json:	"manifest_version": 2
./MobileFrontend/extension.json:	"manifest_version": 2
./MolHandler/extension.json:	"manifest_version": 1
./Monstranto/extension.json:	"manifest_version": 2
./MontserratFont/extension.json:	"manifest_version": 1
./MP3MediaHandler/extension.json:	"manifest_version": 2
./Mpdf/extension.json:	"manifest_version": 1
./MsCalendar/extension.json:	"manifest_version": 2
./MsCatSelect/extension.json:	"manifest_version": 2
./MsInsert/extension.json:	"manifest_version": 1
./MsLinks/extension.json:	"manifest_version": 2
./MsUpload/extension.json:	"manifest_version": 2
./MsWikiEditor/extension.json:	"manifest_version": 1
./MultiBoilerplate/extension.json:	"manifest_version": 2
./MultiLanguageManager/extension.json:	"manifest_version": 2
./MultiMail/extension.json:	"manifest_version": 2
./MultimediaViewer/extension.json:	"manifest_version": 2
./MWVersionInfo/extension.json:	"manifest_version": 2
./MyVariables/extension.json:	"manifest_version": 2
./NamespaceHTML/extension.json:	"manifest_version": 2
./NamespacePaths/extension.json:	"manifest_version": 2
./NamespacePopups/extension.json:	"manifest_version": 1
./NamespaceRelations/extension.json:	"manifest_version": 2
./NamespaceSidebar/extension.json:	"manifest_version": 1
./NativeSvgHandler/extension.json:	"manifest_version": 2
./NaturalLanguageList/extension.json:	"manifest_version": 2
./NavigationTiming/extension.json:	"manifest_version": 2
./NCBITaxonomyLookup/extension.json:	"manifest_version": 1
./NearbyPages/extension.json:	"manifest_version": 2
./NetworkAuth/extension.json:	"manifest_version": 2
./NewestPages/extension.json:	"manifest_version": 1
./NewsBox/extension.json:	"manifest_version": 1
./NewSignupPage/extension.json:	"manifest_version": 2
./Newsletter/extension.json:	"manifest_version": 2
./NewsTicker/extension.json:	"manifest_version": 2
./NewUserActions/extension.json:	"manifest_version": 1
./NewUserMessage/extension.json:	"manifest_version": 2
./NewUserNotif/extension.json:	"manifest_version": 2
./NoBogusUserpages/extension.json:	"manifest_version": 1
./NoCat/extension.json:	"manifest_version": 1
./NotebookViewer/extension.json:	"manifest_version": 2
./NotesLink/extension.json:	"manifest_version": 1
./NoTitle/extension.json:	"manifest_version": 2
./NSFileRepo/extension.json:	"manifest_version": 2
./NukeDPL/extension.json:	"manifest_version": 1
./Nuke/extension.json:	"manifest_version": 2
./NumberOfWikis/extension.json:	"manifest_version": 1
./NumerAlpha/extension.json:	"manifest_version": 2
./OATHAuth/extension.json:	"manifest_version": 2
./OAuthAuthentication/extension.json:	"manifest_version": 2
./OAuth/extension.json:	"manifest_version": 2
./OAuthRateLimiter/extension.json:	"manifest_version": 2
./OdbcDatabase/extension.json:	"manifest_version": 2
./OnlineStatusBar/extension.json:	"manifest_version": 2
./OnlyRecentRecentChanges/extension.json:	"manifest_version": 2
./OOJSPlus/extension.json:	"manifest_version": 2
./OOJsUIAjaxLogin/extension.json:	"manifest_version": 1
./OpenBadges/extension.json:	"manifest_version": 2
./OpenGraphMeta/extension.json:	"manifest_version": 1
./OpenIDConnect/extension.json:	"manifest_version": 2
./OpenJsCad/extension.json:	"manifest_version": 1
./OpenLayers/extension.json:	"manifest_version": 2
./OpenStackManager/extension.json:	"manifest_version": 2
./ORES/extension.json:	"manifest_version": 2
./OrphanedTalkPages/extension.json:	"manifest_version": 1
./OurWorldInData/extension.json:	"manifest_version": 2
./PageAssessments/extension.json:	"manifest_version": 2
./PageAuthors/extension.json:	"manifest_version": 2,
./PageCheckout/extension.json:	"manifest_version": 2
./PageCreationNotif/extension.json:	"manifest_version": 2
./PageDisqus/extension.json:	"manifest_version": 2
./PagedTiffHandler/extension.json:	"manifest_version": 2
./PageExchange/extension.json:	"manifest_version": 2
./PageForms/extension.json:	"manifest_version": 1
./PageImages/extension.json:	"manifest_version": 2
./PageInCat/extension.json:	"manifest_version": 1
./PageLanguage/extension.json:	"manifest_version": 2
./PageMagic/extension.json:	"manifest_version": 2
./PageNameFormula/extension.json:	"manifest_version": 1
./PageNotice/extension.json:	"manifest_version": 2
./PageOwnership/extension.json:	"manifest_version": 1
./PagePermissions/extension.json:	"manifest_version": 1
./PagePopups/extension.json:	"manifest_version": 1
./PageProperties/extension.json:	"manifest_version": 1
./PageSchemas/extension.json:	"manifest_version": 1,
./PagesList/extension.json:	"manifest_version": 2
./PageTools/extension.json:	"manifest_version": 2
./PageTriage/extension.json:	"manifest_version": 2
./PageViewInfo/extension.json:	"manifest_version": 2
./PaginateText/extension.json:	"manifest_version": 2
./PanScroll/extension.json:	"manifest_version": 2
./ParentPage/extension.json:	"manifest_version": 1
./ParserFunctions/extension.json:	"manifest_version": 2
./ParserMigration/extension.json:	"manifest_version": 1,
./PasswordlessLogin/extension.json:	"manifest_version": 2
./Patroller/extension.json:	"manifest_version": 1
./PdfHandler/extension.json:	"manifest_version": 2
./PerformanceInspector/extension.json:	"manifest_version": 2
./PerPageLanguage/extension.json:	"manifest_version": 2
./Petition/extension.json:	"manifest_version": 2
./PGFTikZ/extension.json:	"manifest_version": 2
./PhabTaskGraph/extension.json:	"manifest_version": 2
./Phonos/extension.json:	"manifest_version": 2,
./PhotoSwipe/extension.json:	"manifest_version": 2
./PhpHighlight/extension.json:	"manifest_version": 2
./PhpTags/extension.json:	"manifest_version": 1
./PhpTagsFunctions/extension.json:	"manifest_version": 1
./PhpTagsSMW/extension.json:	"manifest_version": 1
./PhpTagsSPARQL/extension.json:	"manifest_version": 1
./PhpTagsWidgets/extension.json:	"manifest_version": 1
./PhpTagsWiki/extension.json:	"manifest_version": 1
./PictureGame/extension.json:	"manifest_version": 1
./PipeEscape/extension.json:	"manifest_version": 2
./PluggableAuth/extension.json:	"manifest_version": 2
./PluggableSSO/extension.json:	"manifest_version": 1
./Poem/extension.json:	"manifest_version": 2
./Poll/extension.json:	"manifest_version": 2
./PollNY/extension.json:	"manifest_version": 1
./PoolCounter/extension.json:	"manifest_version": 2
./PopcornEditor/extension.json:	"manifest_version": 2
./PopupAlerts/extension.json:	"manifest_version": 2
./Popups/extension.json:	"manifest_version": 2
./PreferencesList/extension.json:	"manifest_version": 1
./Prezi/extension.json:	"manifest_version": 1
./PrivateDomains/extension.json:	"manifest_version": 1
./PronunciationRecording/extension.json:	"manifest_version": 2
./ProofreadPage/extension.json:	"manifest_version": 2
./PropertySuggester/extension.json:	"manifest_version": 2
./Prop/extension.json:	"manifest_version": 2
./ProtectionIndicator/extension.json:	"manifest_version": 2
./ProtectSite/extension.json:	"manifest_version": 1
./Push/extension.json:	"manifest_version": 2
./PushToWatch/extension.json:	"manifest_version": 2
./Quantcast/extension.json:	"manifest_version": 1
./QuickGV/extension.json:	"manifest_version": 1
./QuickInstantCommons/extension.json:	"manifest_version": 2
./QuickSearchLookup/extension.json:	"manifest_version": 1
./QuickSurveys/extension.json:	"manifest_version": 2,
./Quiz/extension.json:	"manifest_version": 2
./QuizGame/extension.json:	"manifest_version": 1
./RandomArea/extension.json:	"manifest_version": 2
./RandomGameUnit/extension.json:	"manifest_version": 1
./RandomImageByCategory/extension.json:	"manifest_version": 1
./RandomImage/extension.json:	"manifest_version": 1,
./RandomInCategory/extension.json:	"manifest_version": 1
./RandomPages/extension.json:	"manifest_version": 1
./RandomSelection/extension.json:	"manifest_version": 2
./ReadingLists/extension.json:	"manifest_version": 2
./RealMe/extension.json:	"manifest_version": 2
./Realnames/extension.json:	"manifest_version": 1
./ReassignEdits/extension.json:	"manifest_version": 2
./RedirectManager/extension.json:	"manifest_version": 2
./RefreshSpecial/extension.json:	"manifest_version": 1
./RegexBlock/extension.json:	"manifest_version": 1
./RegexFunctions/extension.json:	"manifest_version": 2
./RegularTooltips/extension.json:	"manifest_version": 1
./RelatedArticles/extension.json:	"manifest_version": 2,
./RelatedSites/extension.json:	"manifest_version": 1
./RelMicroformat/extension.json:	"manifest_version": 2
./Renameuser/extension.json:	"manifest_version": 2
./ReplaceSet/extension.json:	"manifest_version": 1
./ReplaceText/extension.json:	"manifest_version": 1
./Report/extension.json:	"manifest_version": 2,
./RevisionCommentSupplement/extension.json:	"manifest_version": 2
./RevisionSlider/extension.json:	"manifest_version": 2,
./RightFunctions/extension.json:	"manifest_version": 2
./RSS/extension.json:	"manifest_version": 2
./S5SlideShow/extension.json:	"manifest_version": 1
./SafeDelete/extension.json:	"manifest_version": 2
./SandboxLink/extension.json:	"manifest_version": 2
./Sarcasm/extension.json:	"manifest_version": 2
./SaveSpinner/extension.json:	"manifest_version": 2
./Score/extension.json:	"manifest_version": 2
./Screenplay/extension.json:	"manifest_version": 2
./Scribunto/extension.json:	"manifest_version": 2
./ScrollableTables/extension.json:	"manifest_version": 2
./SearchExtraNS/extension.json:	"manifest_version": 2,
./SearchStats/extension.json:	"manifest_version": 2
./SearchThumbs/extension.json:	"manifest_version": 2
./SearchVue/extension.json:	"manifest_version": 2,
./SectionDisqus/extension.json:	"manifest_version": 1
./SecureAuth/extension.json:	"manifest_version": 2
./SecureHTML/extension.json:	"manifest_version": 1
./SecureLinkFixer/extension.json:	"manifest_version": 2
./SecurePoll/extension.json:	"manifest_version": 2
./SecureSessions/extension.json:	"manifest_version": 2
./SecurityApi/extension.json:	"manifest_version": 2
./SelectTag/extension.json:	"manifest_version": 2
./SemanticACL/extension.json:	"manifest_version": 2
./SemanticDrilldown/extension.json:	"manifest_version": 1
./SemanticRating/extension.json:	"manifest_version": 1,
./SemanticRESTAPI/extension.json:	"manifest_version": 2,
./SendGrid/extension.json:	"manifest_version": 2
./Sentry/extension.json:	"manifest_version": 1
./SharedHelpPages/extension.json:	"manifest_version": 1
./Share/extension.json:	"manifest_version": 2
./Shibboleth/extension.json:	"manifest_version": 1
./ShortUrl/extension.json:	"manifest_version": 2
./ShoutWikiAds/extension.json:	"manifest_version": 1
./ShoutWikiAPI/extension.json:	"manifest_version": 1
./ShowMe/extension.json:	"manifest_version": 1
./ShowRealUsernames/extension.json:	"manifest_version": 2
./SidebarDonateBox/extension.json:	"manifest_version": 2
./SimilarEditors/extension.json:	"manifest_version": 2
./SimpleCalendar/extension.json:	"manifest_version": 2
./SimpleChanges/extension.json:	"manifest_version": 2
./SimpleSAMLphp/extension.json:	"manifest_version": 2
./SimpleSort/extension.json:	"manifest_version": 1
./SiteMatrix/extension.json:	"manifest_version": 2
./SiteMetrics/extension.json:	"manifest_version": 1
./SiteSettings/extension.json:	"manifest_version": 2
./SkinPerNamespace/extension.json:	"manifest_version": 2
./SkinPerPage/extension.json:	"manifest_version": 1
./SmiteSpam/extension.json:	"manifest_version": 2
./Sofa/extension.json:	"manifest_version": 1
./SoftRedirector/extension.json:	"manifest_version": 1
./SoftwareVersion/extension.json:	"manifest_version": 1
./SpamBlacklist/extension.json:	"manifest_version": 2
./SpamDiffTool/extension.json:	"manifest_version": 1
./SpamRegex/extension.json:	"manifest_version": 1
./Spark/extension.json:	"manifest_version": 2
./SparkPost/extension.json:	"manifest_version": 1
./Special404/extension.json:	"manifest_version": 1
./SpecialNamespaces/extension.json:	"manifest_version": 2
./SpellingApi/extension.json:	"manifest_version": 1
./SpellingDictionary/extension.json:	"manifest_version": 2
./SphinxSearch/extension.json:	"manifest_version": 1
./SplitPrivateWiki/extension.json:	"manifest_version": 2
./SportsTeams/extension.json:	"manifest_version": 1
./StaffEdits/extension.json:	"manifest_version": 1
./StaffPowers/extension.json:	"manifest_version": 1
./StandardDialogs/extension.json:	"manifest_version": 2
./StatCounter/extension.json:	"manifest_version": 2
./StickyTOC/extension.json:	"manifest_version": 2
./StlHandler/extension.json:	"manifest_version": 1
./StopForumSpam/extension.json:	"manifest_version": 2
./StructuredNavigation/extension.json:	"manifest_version": 2
./SubpageFun/extension.json:	"manifest_version": 1
./SubPageList3/extension.json:	"manifest_version": 2
./SubpageSortkey/extension.json:	"manifest_version": 2
./Sudo/extension.json:	"manifest_version": 1
./SVGEdit/extension.json:	"manifest_version": 2
./SwiftMailer/extension.json:	"manifest_version": 2
./SyntaxHighlight_GeSHi/extension.json:	"manifest_version": 2
./Tabber/extension.json:	"manifest_version": 1
./Tabs/extension.json:	"manifest_version": 2
./TEI/extension.json:	"manifest_version": 2
./TemplateData/extension.json:	"manifest_version": 2
./TemplateSandbox/extension.json:	"manifest_version": 2
./TemplateStyles/extension.json:	"manifest_version": 2,
./TemplateWizard/extension.json:	"manifest_version": 2
./TestLanguageNameGrammar/extension.json:	"manifest_version": 1
./TextExtracts/extension.json:	"manifest_version": 2
./TextScroller/extension.json:	"manifest_version": 1
./Thanks/extension.json:	"manifest_version": 2
./Theme/extension.json:	"manifest_version": 1
./TheWikipediaLibrary/extension.json:	"manifest_version": 2
./ThrottleOverride/extension.json:	"manifest_version": 2
./TimedMediaHandler/extension.json:	"manifest_version": 2
./timeline/extension.json:	"manifest_version": 2
./TimelineTable/extension.json:	"manifest_version": 2
./TimeMachine/extension.json:	"manifest_version": 2
./TinyMCE/extension.json:	"manifest_version": 1
./TitleBlacklist/extension.json:	"manifest_version": 2
./TitleIcon/extension.json:	"manifest_version": 2
./TitleKey/extension.json:	"manifest_version": 1
./TocTree/extension.json:	"manifest_version": 2
./Toolhub/extension.json:	"manifest_version": 2,
./Tooltip/extension.json:	"manifest_version": 2
./TopTenPages/extension.json:	"manifest_version": 1
./TorBlock/extension.json:	"manifest_version": 2
./Translate/extension.json:	"manifest_version": 2
./TranslateSvg/extension.json:	"manifest_version": 2
./TranslationNotifications/extension.json:	"manifest_version": 2
./TrustedXFF/extension.json:	"manifest_version": 2
./TuleapIntegration/extension.json:	"manifest_version": 2
./TuleapWikiFarm/extension.json:	"manifest_version": 2
./TweetANew/extension.json:	"manifest_version": 2
./TwitterCards/extension.json:	"manifest_version": 2
./TwitterTag/extension.json:	"manifest_version": 1
./TwnMainPage/extension.json:	"manifest_version": 1
./TwoColConflict/extension.json:	"manifest_version": 2,
./UIFeedback/extension.json:	"manifest_version": 2
./UILangCode/extension.json:	"manifest_version": 2
./UnCaptcha/extension.json:	"manifest_version": 2
./UnicodeConverter/extension.json:	"manifest_version": 2
./UnifiedTaskOverview/extension.json:	"manifest_version": 2
./UniversalLanguageSelector/extension.json:	"manifest_version": 2
./UnlinkedWikibase/extension.json:	"manifest_version": 2
./UnusedRedirects/extension.json:	"manifest_version": 1
./UpdateMediaWiki/extension.json:	"manifest_version": 1
./UploadBlacklist/extension.json:	"manifest_version": 1
./UploadsLink/extension.json:	"manifest_version": 2,
./UploadWizard/extension.json:	"manifest_version": 2
./UrlGetParameters/extension.json:	"manifest_version": 2
./UrlShortener/extension.json:	"manifest_version": 2
./UserAgreement/extension.json:	"manifest_version": 1,
./UseResource/extension.json:	"manifest_version": 2
./UserExport/extension.json:	"manifest_version": 2
./UserFunctions/extension.json:	"manifest_version": 2
./UserGroups/extension.json:	"manifest_version": 2
./UserMerge/extension.json:	"manifest_version": 2
./UserOptionStats/extension.json:	"manifest_version": 1
./UserPageEditProtection/extension.json:	"manifest_version": 2
./UserPageViewTracker/extension.json:	"manifest_version": 2
./UserProtect/extension.json:	"manifest_version": 2
./UserStatus/extension.json:	"manifest_version": 1
./Variables/extension.json:	"manifest_version": 2
./VEForAll/extension.json:	"manifest_version": 1
./VersionCompare/extension.json:	"manifest_version": 2
./Video/extension.json:	"manifest_version": 1
./VIKI/extension.json:	"manifest_version": 1
./VikiSemanticTitle/extension.json:	"manifest_version": 1
./VikiTitleIcon/extension.json:	"manifest_version": 1
./VipsScaler/extension.json:	"manifest_version": 2
./VisualEditor/extension.json:	"manifest_version": 2
./VoteNY/extension.json:	"manifest_version": 1
./VueTest/extension.json:	"manifest_version": 2
./WantedPagesFromNS/extension.json:	"manifest_version": 2
./WatchAnalytics/extension.json:	"manifest_version": 1
./WatchSubpages/extension.json:	"manifest_version": 1
./WebAuthn/extension.json:	"manifest_version": 2
./WebChat/extension.json:	"manifest_version": 2
./WebDAV/extension.json:	"manifest_version": 2
./WebToolsManager/extension.json:	"manifest_version": 2,
./WhitelistPages/extension.json:	"manifest_version": 1
./WhiteSpace/extension.json:	"manifest_version": 2
./WhoIsWatching/extension.json:	"manifest_version": 1
./WhosOnline/extension.json:	"manifest_version": 2
./Widgets/extension.json:	"manifest_version": 2
./Wigo3/extension.json:	"manifest_version": 2,
./WikEdDiff/extension.json:	"manifest_version": 2
./WikibaseCirrusSearch/extension.json:	"manifest_version": 2
./WikibaseLexemeCirrusSearch/extension.json:	"manifest_version": 2
./WikibaseLexeme/extension.json:	"manifest_version": 2
./WikibaseManifest/extension.json:	"manifest_version": 2,
./WikibaseMediaInfo/extension.json:	"manifest_version": 2,
./WikibaseQualityConstraints/extension.json:	"manifest_version": 2
./WikibaseStatementUpdater/extension.json:	"manifest_version": 2,
./WikiCategoryTagCloud/extension.json:	"manifest_version": 1
./Wikidata.org/extension.json:	"manifest_version": 2
./WikidataPageBanner/extension.json:	"manifest_version": 2
./WikiEditor/extension.json:	"manifest_version": 2
./WikiForum/extension.json:	"manifest_version": 1
./wikihiero/extension.json:	"manifest_version": 2
./WikiLambda/extension.json:	"manifest_version": 2
./WikiLove/extension.json:	"manifest_version": 2
./WikiLovesMonuments/extension.json:	"manifest_version": 2
./WikimediaApiPortalOAuth/extension.json:	"manifest_version": 2
./WikimediaBadges/extension.json:	"manifest_version": 2
./WikimediaEditorTasks/extension.json:	"manifest_version": 2
./WikimediaEvents/extension.json:	"manifest_version": 2
./WikimediaIncubator/extension.json:	"manifest_version": 2
./WikimediaMaintenance/extension.json:	"manifest_version": 2,
./WikimediaMessages/extension.json:	"manifest_version": 2
./WikiSEO/extension.json:	"manifest_version": 2
./WikiShare/extension.json:	"manifest_version": 2
./Wikisource/extension.json:	"manifest_version": 2
./Wikispeech/extension.json:	"manifest_version": 2,
./WikispeechSpeechDataCollector/extension.json:	"manifest_version": 2,
./Wikistories/extension.json:	"manifest_version": 2
./WikiTextLoggedInOut/extension.json:	"manifest_version": 1
./WikiToLDAP/extension.json:	"manifest_version": 2
./WikiVideos/extension.json:	"manifest_version": 2
./WindowsAzureStorage/extension.json:	"manifest_version": 1
./Workflows/extension.json:	"manifest_version": 2,
./WSOAuth/extension.json:	"manifest_version": 2
./XAnalytics/extension.json:	"manifest_version": 2
./XenForoAuth/extension.json:	"manifest_version": 1
./XSL/extension.json:	"manifest_version": 2,
./YetAnotherKeywords/extension.json:	"manifest_version": 2
./YotpoReviews/extension.json:	"manifest_version": 1
./YouTube/extension.json:	"manifest_version": 1
